*****************************************
*********************     *             *
** *                  *** * ******* *** *
** * ********* * ** *   * *    *    * * *
** *        ** * ** ***** **** **** * ***
** ******** ** *                 *
**          ** **** ***** ****** * ******
** *********** **** *  ** *    * *      *
**                  **  * * ** * ****** *
** ** ***** *** *****  ** * *  *        *
** ** ***** *** *   * *** * * ** ********
*  *****        *** *     * * *  *   * **
**  **** ******     ***** *** ** * * *  *
***  *** ****** ***            *** * ** *
****     ******   ************     *    *
*****************************************